##########
##### ####
##### ####
##### ####
##### ####
##### ####
##### ####
##### ####
#        #
#####E####