#####E####
# #    # #
###    ###
#        #
#        #
#        #
#        #
###      #
# #      #
#####E####