##########
E        #
######## #
######## #
######## #
######## #
######## #
######## #
#        #
##########