##########
#        #
# ###### #
#        #
# ### ####
#        #
## ##### #
#        #
# ###### #
#E########
