##########
#   #  # #
# ###    #
# #   # ##
# # # #  #
#    #  ##
## #  #  #
#  #  ## #
# ### #  #
#####E####